26
8
4 4 4 0 0 0 0 0 0 4 4 0 0 0 0 0 0 0 0 0 4 4 4 4 4
0 0 0 0 0 4 0 0 0 0 4 0 0 0 4 4 0 0 4 0 4 4 4 4 4
4 0 0 0 4 4 0 0 0 0 0 0 0 4 4 4 0 0 0 0 0 4 4 4 4
4 4 4 4 0 4 0 0 0 0 0 0 0 4 0 0 0 0 0 0 0 0 0 0 0
4 4 4 4 0 0 0 4 0 0 4 0 0 0 0 4 0 0 4 0 0 4 0 0 0
4 4 4 4 4 4 4 4 0 0 4 0 0 4 4 4 0 4 4 0 0 0 0 4 4
4 4 4 4 4 4 4 4 0 0 4 4 0 4 4 4 0 4 4 0 4 4 0 4 4
4 4 4 4 4 4 4 4 0 0 4 4 0 4 4 4 0 4 4 0 4 4 0 4 4

For ice state
